Microsoft Windows [Version 10.0.19045.3570]
(c) Microsoft Corporation. All rights reserved.

C:\Users\Javid>docker pull postgres
Using default tag: latest
error during connect: this error may indicate that the docker daemon is not running: Post "http://%2F%2F.%2Fpipe%2Fdocker_engine/v1.24/images/create?fromImage=postgres&tag=latest": open //./pipe/docker_engine: The system cannot find the file specified.

C:\Users\Javid>docker pull postgres
Using default tag: latest
latest: Pulling from library/postgres
Digest: sha256:3d9ed832906091d609cfd6f283e79492ace01ba15866b21d8a262e8fd1cdfb55
Status: Image is up to date for postgres:latest
docker.io/library/postgres:latest

What's Next?
  View a summary of image vulnerabilities and recommendations → docker scout quickview postgres

C:\Users\Javid>docker run -d --name Assignment2_v6 -p 5432:5432 -e POSTGRES_PASSWORD=prius postgres
86664c738d28e7d4bc8629c1a43e2f0a480d06f47c8d11c5b517ec6e4d788847

C:\Users\Javid>docker exec -it Assignment2_v6 bash
root@86664c738d28:/# psql -h localhost -U dist_user_123
psql: error: connection to server at "localhost" (127.0.0.1), port 5432 failed: FATAL:  role "dist_user_123" does not exist
root@86664c738d28:/# psql -h localhost -U localhost
psql: error: connection to server at "localhost" (127.0.0.1), port 5432 failed: FATAL:  role "localhost" does not exist
root@86664c738d28:/# psql -h dist_user_123 -U postgres
^[[Apsql: error: could not translate host name "dist_user_123" to address: Temporary failure in name resolution
root@86664c738d28:/# psql -h localhost -U localhost
psql: error: connection to server at "localhost" (127.0.0.1), port 5432 failed: FATAL:  role "localhost" does not exist
root@86664c738d28:/# psql -h localhost -U postgres
psql (16.0 (Debian 16.0-1.pgdg120+1))
Type "help" for help.

postgres=# CREATE DATABASE ASYNC_IMAGES(
postgres(# RECORD_ID SERIAL PRIMARY KEY,
postgres(# SENDER NAME VARCHAR(30),
postgres(# MESSAGE VARCHAR(30),
postgres(# SENT_TIME TIMESTAMP,
postgres(# RECEIVED_TIME TIMESTAMP);
ERROR:  syntax error at or near "("
LINE 1: CREATE DATABASE ASYNC_IMAGES(
                                    ^
postgres=# CREATE DATABASE ASYNC_IMAGES (
RECORD_ID SERIAL PRIMARY KEY,
SENDER NAME VARCHAR(30),
MESSAGE VARCHAR(30),
SENT_TIME TIMESTAMP,
RECEIVED_TIME TIMESTAMP);
ERROR:  syntax error at or near "("
LINE 1: CREATE DATABASE ASYNC_IMAGES (
                                     ^
postgres=# CREATE DATABASE ASYNC_MESSAGES (
RECORD_ID SERIAL PRIMARY KEY,
SENDER NAME VARCHAR(30),
MESSAGE VARCHAR(30),
SENT_TIME TIMESTAMP,
RECEIVED_TIME TIMESTAMP);
ERROR:  syntax error at or near "("
LINE 1: CREATE DATABASE ASYNC_MESSAGES (
                                       ^
postgres=# CREATE DATABASE test6;
CREATE DATABASE
postgres=# \c test6
You are now connected to database "test6" as user "postgres".
test6=# CREATE DATABASE ASYNC_MESSAGES (
RECORD_ID SERIAL PRIMARY KEY,
SENDER NAME VARCHAR(30),
MESSAGE VARCHAR(30),
SENT_TIME TIMESTAMP,
RECEIVED_TIME TIMESTAMP);
ERROR:  syntax error at or near "("
LINE 1: CREATE DATABASE ASYNC_MESSAGES (
                                       ^
test6=# CREATE TABLE ASYNC_MESSAGES (
RECORD_ID SERIAL PRIMARY KEY,
SENDER NAME VARCHAR(30),
MESSAGE VARCHAR(30),
SENT_TIME TIMESTAMP,
RECEIVED_TIME TIMESTAMP);
ERROR:  syntax error at or near "VARCHAR"
LINE 3: SENDER NAME VARCHAR(30),
                    ^
test6=# CREATE TABLE ASYNC_MESSAGES (
RECORD_ID SERIAL PRIMARY KEY,
SENDER_NAME VARCHAR(30),
MESSAGE VARCHAR(30),
SENT_TIME TIMESTAMP,
RECEIVED_TIME TIMESTAMP);
CREATE TABLE
test6=# /L
test6-# \L
invalid command \L
Try \? for help.
test6-# \l
                                                      List of databases
   Name    |  Owner   | Encoding | Locale Provider |  Collate   |   Ctype    | ICU Locale | ICU Rules |
  Access privileges
-----------+----------+----------+-----------------+------------+------------+------------+-----------+-
----------------------
 postgres  | postgres | UTF8     | libc            | en_US.utf8 | en_US.utf8 |            |           |
 template0 | postgres | UTF8     | libc            | en_US.utf8 | en_US.utf8 |            |           |
=c/postgres          +
           |          |          |                 |            |            |            |           |
postgres=CTc/postgres
 template1 | postgres | UTF8     | libc            | en_US.utf8 | en_US.utf8 |            |           |
=c/postgres          +
           |          |          |                 |            |            |            |           |
postgres=CTc/postgres
 test6     | postgres | UTF8     | libc            | en_US.utf8 | en_US.utf8 |            |           |
(4 rows)












































test6-# CREATE USER dist_user WITH PASSWORD 'dist_pass_123';
ERROR:  syntax error at or near "/"
LINE 1: /L
        ^
test6=# CREATE USER dist_user WITH PASSWORD 'dist_pass_123';
CREATE ROLE
test6=# exit
root@86664c738d28:/# psql
psql: error: connection to server on socket "/var/run/postgresql/.s.PGSQL.5432" failed: FATAL:  role "root" does not exist
root@86664c738d28:/# psql -h dist_user_123 -U postgres
psql: error: could not translate host name "dist_user_123" to address: Name or service not known
root@86664c738d28:/# psql -h dist_user -U postgres
psql: error: could not translate host name "dist_user" to address: Name or service not known
root@86664c738d28:/# psql -h
/usr/lib/postgresql/16/bin/psql: option requires an argument -- 'h'
psql: hint: Try "psql --help" for more information.
root@86664c738d28:/# psql --help
psql is the PostgreSQL interactive terminal.

Usage:
  psql [OPTION]... [DBNAME [USERNAME]]

General options:
  -c, --command=COMMAND    run only single command (SQL or internal) and exit
  -d, --dbname=DBNAME      database name to connect to (default: "root")
  -f, --file=FILENAME      execute commands from file, then exit
  -l, --list               list available databases, then exit
  -v, --set=, --variable=NAME=VALUE
                           set psql variable NAME to VALUE
                           (e.g., -v ON_ERROR_STOP=1)
  -V, --version            output version information, then exit
  -X, --no-psqlrc          do not read startup file (~/.psqlrc)
  -1 ("one"), --single-transaction
                           execute as a single transaction (if non-interactive)
  -?, --help[=options]     show this help, then exit
      --help=commands      list backslash commands, then exit
      --help=variables     list special variables, then exit

Input and output options:
  -a, --echo-all           echo all input from script
  -b, --echo-errors        echo failed commands
  -e, --echo-queries       echo commands sent to server
  -E, --echo-hidden        display queries that internal commands generate
  -L, --log-file=FILENAME  send session log to file
  -n, --no-readline        disable enhanced command line editing (readline)
  -o, --output=FILENAME    send query results to file (or |pipe)
  -q, --quiet              run quietly (no messages, only query output)
  -s, --single-step        single-step mode (confirm each query)
  -S, --single-line        single-line mode (end of line terminates SQL command)

Output format options:
  -A, --no-align           unaligned table output mode
      --csv                CSV (Comma-Separated Values) table output mode
  -F, --field-separator=STRING
                           field separator for unaligned output (default: "|")
  -H, --html               HTML table output mode
  -P, --pset=VAR[=ARG]     set printing option VAR to ARG (see \pset command)
  -R, --record-separator=STRING
                           record separator for unaligned output (default: newline)
  -t, --tuples-only        print rows only
  -T, --table-attr=TEXT    set HTML table tag attributes (e.g., width, border)
  -x, --expanded           turn on expanded table output
  -z, --field-separator-zero
                           set field separator for unaligned output to zero byte
  -0, --record-separator-zero
                           set record separator for unaligned output to zero byte

Connection options:
  -h, --host=HOSTNAME      database server host or socket directory (default: "local socket")
  -p, --port=PORT          database server port (default: "5432")
  -U, --username=USERNAME  database user name (default: "root")
  -w, --no-password        never prompt for password
  -W, --password           force password prompt (should happen automatically)

For more information, type "\?" (for internal commands) or "\help" (for SQL
commands) from within psql, or consult the psql section in the PostgreSQL
documentation.

Report bugs to <pgsql-bugs@lists.postgresql.org>.
PostgreSQL home page: <https://www.postgresql.org/>
root@86664c738d28:/# psql
psql: error: connection to server on socket "/var/run/postgresql/.s.PGSQL.5432" failed: FATAL:  role "root" does not exist
root@86664c738d28:/# psql -U dist_user
psql: error: connection to server on socket "/var/run/postgresql/.s.PGSQL.5432" failed: FATAL:  database "dist_user" does not exist
root@86664c738d28:/# psql -U test6  dist_user
psql: error: connection to server on socket "/var/run/postgresql/.s.PGSQL.5432" failed: FATAL:  role "test6" does not exist
root@86664c738d28:/# psql -U dist_user test6
psql (16.0 (Debian 16.0-1.pgdg120+1))
Type "help" for help.

test6=>
